111111111111111111111
100000000000000000001
101010111000111010101
101010001010100010101
101010000010000010101
101010010000010010101
100000010000010000001
100100000000000001001
100111001000100111001
1100000010E0100000011
000000000111000000000
100001100000001100001
111101101111101101111
100000000010000000001
100010001010100010001
111000101010101000111
100000100000001000001
100000100010001000001
100111111000111111001
1000000000P0000000001
111111111111111111111