11111111111111111111111111111111
10000011100101011010100111000001
10P00000000000000000000000000001
11100000000000000000000000000001
11000000000001111110000000000001
00000000000010000001000000E00000
11000000000100000000100000000011
11000111000000000000000011100011
11000000000000000000000000000001
11100000000000000000000000000001
00000000000000000000000000000000
00000000011100000000000000000000
10000000000001110000000000000001
11110000001100000000000000000001
10000011100000000000000000000001
11111000000000000000000000000001
11111110000000000000000000000001
11111111111111111111111111111111